........||....
........||....
..||||..||....
..||||..||....
....||..||||..
....||..||||..
........||....
....|...||.|..
....|......|..
....|......|..
....|...||.|..
....|...||.|..
..||||..||.|..
..||||P.||.|..