........||...|
........||...|
..||||..||...|
..||||..||....
....||..||||.|
....||..||||..
........||....
....|...||.|.|
..|||.|....|..
....|||...|...
....|...||.|.|
....|...||.|..
..||||..||.|..
..||||P.||.|..